................
@..##|########..
....#|...#......
#####|...#######
.....|..........
.....|..........
....#####.......
#@.........@....
..............@.
................
.@#|.@@...#|.###
..#|......#|....
@.#|......#|....
..#|......#|....
.@#|......#|....
..#|......#|....
