.......#........
....#..#######..
..######........
...............#
.##.............
.####.........#.
.......#########
................
#####...........
................
.......#####....
................
..............##
.......#####....
..###...........
..###...........
