.......#........
....#..#######..
..######........
...............#
.##.............
.####.........#.
.......#########
................
#####...........
................
.......#####....
................
.|##|.........##
.|##|.######....
.|##|...........
.|##|...........
