................
#..##|########..
....#|...#......
#####|...#######
.....|..........
.....|..........
....#####.......
##.........#....
..............#.
................
.##|.##...#|.###
..#|......#|....
#.#|......#|....
..#|......#|....
.##|......#|....
..#|......#|....
