................
................
####.######.####
................
....#......#....
................
......####......
................
....#......#....
................
......####......
....#......#....
................
...##########...
..##........##..
................
