#...............
#....###........
##########.###..
................
.....#.........#
#...###.#.#.#.##
.....#.........#
...#############
#..............#
##|###....###|##
..|..#....#..|..
..|..######..|..
..|..........|..
..|#..####..#|..
..|#........#|..
..|##......##|..
