.....#...####...
..####........#|
.....##########|
#..............|
##.##.....######
....##.##.......
................
......#..#......
..##.#####..##..
................
######....######
.......##.......
.|###|####|###|.
.|#..|....|..#|.
.|#..|....|..#|.
.|#..|....|..#|.
