.....#...@##@...
..@###........#|
.....##########|
@..............|
##.##.....######
....##.@@.......
................
......@..@......
..@@.#####..@@..
................
######....######
.......##.......
.|###|####|###|.
.|#..|....|..#|.
.|#..|....|..#|.
.|#..|....|..#|.
