................
...#........#...
...#........#...
..############..
................
##............##
...####||####...
.......||.......
#.##...||......#
#..#...||...#..#
####..|##|..####
......|..|......
....#.|..|.#....
...##......##...
..###......###..
.####......####.
