#...............
#....##@........
@#########.###..
................
.....#.........#
@...###.@.@.@.##
.....#.........#
...@############
#..............#
##|##@....###|##
..|..#....#..|..
..|..@#####..|..
..|..........|..
..|#..####..#|..
..|#........#|..
..|##......##|..
