................
....###||###....
.......||.......
####.|.##.|.####
...##|####|##...
.....|....|.....
.....|....|.....
....###||###....
###....||....###
.......||.......
.......||.......
.......||.......
......####......
................
..############..
................
