#....##||##....#
#|.....||......#
#|.#############
#|.............#
#|.............#
#############..#
#..............#
########......##
#|.......#.....#
#|..........#..#
#|##############
#|............|#
#|............|#
##############|.
..............|.
..............|.
