................
#########.......
........###.####
................
..........##....
................
........##......
................
......##........
................
........##......
................
......##........
................
........##......
................
