#...............
#....##@........
@#########.###..
................
g....#.........#
@...###.@.@.@.##
.....#!!!!!!!!!#
...@############
#..............#
##|##@....###|##
..|..#....#..|..
..|..@#####..|..
..|..........|..
..|#..####..#|..
..|#........#|..
..|##......##|..
