#....##||##....#
#|..g..||....g.#
#|.#############
#|.............#
#|..g..g..g....#
#############..#
#G.............#
########......##
#|.......#.....#
#|.g...g..g.#..#
#|##############
#|............|#
#|.g..g..g....|#
##############|#
..............|#
..............|#
