#...............
#....##@........
@#########.###..
................
g....#.........#
@...###.@.@.@.##
....g#!!!!!!!!!#
...@############
#..............#
##|##@....###|##
..|..#gggg#..|..
..|..@#####..|..
..|..........|..
..|#..####..#|..
..|#........#|..
..|##......##|.g
