....g#@..@##@...
..@###.g.geg..#|
.....##########|
@.........e...e|
##.##.....######
....##.@@.......
..*..........*..
...g..@..@......
..@@.#####..@@..
g.e.g......g.e.g
######....######
.......##.......
.|###|####|###|.
.|#bp|b12b|pb#|.
.|#..|.34.|..#|.
.|#ge|....|eg#|g
