.....e....e.....
.W..###||###..W.
eg.....||.....ge
####.|.##.|.####
...##|####|##...
.b...|....|...b.
....g|e..e|g....
g^e.===||===.e^g
###....||....###
.......||.......
.......||.......
......e||e......
.b....====....b.
...g^.E..E.^g...
..############..
................
