................
....###||###....
.......||.......
####.|.##.|.####
...##|####|##...
.....|....|.....
.....|....|.....
....===||===....
###....||....###
.......||.......
.......||.......
.......||.......
......====......
................
..############..
................
