b.b.b......b.b.b
......####......
GggG.GegegeG....
####.=======....
..............ge
..............##
#|#.#.E.E.E.E...
#|#sss#@@s@@#sss
#|#!!!!!!!!!!!!!
#|#!!!!!!!!!!!!!
#|#!!!!!!!!!!!!!
#|##############
#|..e.e.e.e.e...
###############|
...b.W.W.W.W.b.|
...............|
