................
@..##|########..
...g#|...#g.....
#####|...#######
.....|..........
.....|^^........
....#####.......
#@.........@....
..............@.
................
.@#|.@@@..#|.###
g.#|......#|....
@.#|......#|....
.g#|......###...
.@#|......#...=.
.g#|.g....#^^^^G
