#....##||##....#
#|..ge.||..e.g.#
#|.#############
#|.............#
#|..g.ege.g....#
#############..#
#G.E..E........#
########......##
#|.......#.....#
#|.g...ge.g.#..#
#|##############
#|............|#
#|.ge.g..ge...|#
##############|#
..............|#
..............|#
