#...............
#gE.e##@....E...
@#########.###..
........W.W.W...
g....#.........#
@...###s@s@s@s##
....g#!!!!!!!!!#
...@############
#...E......E...#
##|##@ssss###|##
..|..#gggg#..|..
..|..@#####..|..
..|...g..g..g|..
..|#..####..#|..
..|#g.b..b.g#|..
..|##g....g##|.g
