#...............
#gE..##@....E...
@#########.###..
................
g....#.........#
@...###.@.@.@.##
....g#!!!!!!!!!#
...@############
#...E......E...#
##|##@....###|##
..|..#gggg#..|..
..|..@#####..|..
..|...g..g..g|..
..|#..####..#|..
..|#g......g#|..
..|##g....g##|.g
