#....##||##....#
#|.....||......#
#|.#############
#|.............#
#|.............#
#############..#
#g.............#
########......##
#|.......#.....#
#|..........#..#
#|##############
#|............|#
#|............|#
##############|#
..............|#
..............|#
