.....#.ge...e...
...@g#########..
..####..........
.e.......w.w.w.@
.#@......b.b.b..
.####...ge.ge.@g
.......#########
.geg............
#####..W..W.....
G|......g^g.....
@|.....#####....
.|g....W..W.....
.|##|...geg...@@
.|##|.######....
.|##|...........
.|##|e......e^.G
