.w..w......w..w.
...ssss@@ssss...
...#.e.gg.e.#...
..############..
g....b....b....g
#@..g......g..@#
...====||====...
.......||.......
#..g...||...g..#
#.E#...||...@E.#
###@..|==|..###@
......|..|......
.b..#.|..|.#..b.
...##......##...
.g###......###g.
g####......####g
