.....e....e.....
....###||###....
eg.....||.....ge
####.|.##.|.####
...##|####|##...
.....|....|.....
....g|e..e|g....
g^e.===||===.e^g
###....||....###
.......||.......
.......||.......
......e||e......
......====......
...g^.E..E.^g...
..############..
................
