................
...#...@@...#...
...#........#...
..############..
................
#@............@#
...====||====...
.......||.......
#.#@...||......#
#..#...||...@..#
###@..|==|..###@
......|..|......
....#.|..|.#....
...##......##...
..###......###..
.####......####.
