.....#..........
...@g#########..
..####..........
...............@
.#@.............
.####.........@.
.......#########
................
#####...........
................
.......#####....
................
.|##|.........@@
.|##|.######....
.|##|...........
.|##|...........
