................
@..##|########..
e..g#|...#?.eE.e
#####|...#######
.....|..........
....e|^^e.......
....#####.......
#@.........@....
.....w.w......@.
......e.......e.
.@#|.@@@..#|.###
g.#|......#|....
@.#|......#|....
.g#|......###...
.@#|......#sss=s
.g#|eg....#^^^^G
