#######.#|######
..W.W.W.#|##....
?.G.G..e.|......
#s@s@s@@#|g..e.G
#!!!!!!!#|#s==s#
#!!!!!!!#|#^^^^#
#########|######
.........|......
........====|.ge
.gEEgeg.#w.w|===
#########p.p|p.p
b*b*b*b*#...^...
........#@@@@|@@
GegEgeGe.....|.g
############@#|#
..............|g
