.....#.ge...e...
...@g#########..
..####..........
.e.............@
.#@.............
.####...ge.ge.@g
.......#########
.geg............
#####...........
G|......g^g.....
@|.....#####....
.|g.............
.|##|...geg...@@
.|##|.######....
.|##|...........
.|##|e......e^.G
