....g#@..@##@...
..@###.g.geg..#|
.....##########|
@.........e...e|
##.##.....######
....##.@@.......
................
...g..@..@......
..@@.#####..@@..
g.e.g......g.e.g
######....######
.......##.......
.|###|####|###|.
.|#..|....|..#|.
.|#..|....|..#|.
.|#ge|....|eg#|g
