................
@..##|########..
e..g#|...#g.e..e
#####|...#######
.....|..........
....e|^^e.......
....#####.......
#@.........@....
..............@.
......e.......e.
.@#|.@@@..#|.###
g.#|......#|....
@.#|......#|....
.g#|......###...
.@#|......#sss=s
.g#|eg....#^^^^G
