................
.......@@.......
...#.e.gg.e.#...
..############..
g..............g
#@..g......g..@#
...====||====...
...g...||.......
#.#@...||...g..#
#.E#...||...@E.#
###@..|==|..###@
......|..|......
....#.|..|.#....
...##......##...
.g###......###g.
.####......####g
