.......e..e..E..
bwbwb@@@@@@@@@..
........|......=
eGege...|===@..|
=======.....@=#|
..........w.w..|
..........g^e.G#
.......=..===.==
G....=.#.##!!!!#
#.g....#!!#!!!!#
..#.g..#########
....#...e.......
ssssss##@@#@.#=.
^^^^^^#G|g#..#..
##@#@###|#@.@#.=
........|....#.G
